NO ./textures/texture_no.xpm
SO ./textures/texture_so.xpm
WE ./textures/texture_we.xpm
EA ./textures/texture_ea.xpm

C 96,96,96
F 128,128,128

 111111111111111111111111
110000000011Z000000000001
1Z11000001010000000000001
100100000000000000000000111111111111111111
100000000000000000000000D00W00000000000001
1X0000000011000001110111111111111111111111
11110111111111011100000010001
 1110111111111011101010010001
11Z00000110101011100000000001
10000000000000000000000010001
10000000000Z00001101010010001
110000011101D101111101111DDD111          11111111
11110111 1110101 101111010001            1X000001
11110111 111Z101 101111010001            11000001
11110111 1110101 101111010001            11111101
11110111 1110101 101111010001                 101
11110111 1110101 10111101000111111111111111111101
10000001 1110101110111101000000000000000000000001
10Z00001 1110100000111101000111111111111111111111
11111111 11111111111111111111
