NO ./textures/texture_no.xpm
SO ./textures/texture_so.xpm
WE ./textures/texture_we.xpm
EA ./textures/texture_ea.xpm

C 96,96,96
F 128,128,128



      1111111111111111111
      1000Z00000000000001
      10000000000Z0000001
      1000001000000000001
1111111000001000000111111
10Z0001000001000000100001
100000D0000Z0000000D00001
1000001000000000000100001
100000111111D111111100001
11D11D1000000000001100001
10010000000Z0000001111001
10010000Z000Z000001000001
1X1100000000000000D000001
111111111111111111111D111
  1111111           101
  1000001           101
  110000111111111111101
   100Z0000000000000D01
   10000011111111111101
   1000001          101
   1000001          101
   1111111     111111D1111111
               10000000000001
               10000000000001
               10000011111D11
               100Z0011110001
               1000001  10001
               1111111  10001
                        10N01
                        11111

